31 51

###################################################

        # #   #       #   #     #   #     #   #   #

# ##### # # ### # ### # # # ##### # # ### ### # # #

# #     #       #   #   # #       # #   #     # # #

# # ##### ######### ##### ######### ##### ##### # #

# #   #     #   #   #   #           # #   #   # # #

# ### # ### # ### ### ########### ### # ### # # # #

# # # #   # # #   #         #           # # # # # #

# # # ### # # # ### # # ##### ### ### ### # # # # #

#   #   # # #   #   # #       #   #   #   # #   # #

####### ### ################### ### ### # # ##### #

#   #   #   #   #         # #   # #   # #   #     #

### # ### ### # # ####### # # # # ### # ##### #####

#   #   # #   # #     #   #   # #     #     #     #

# # ### # ##### ##### # # ##### ########### ### # #

# #     # #   #   #   # #   #   #       #   #   # #

# ##### # # # ### ##### ### # ##### ### # ### ### #

# #   # #   #   #     #   # #     # #     #   #   #

# ### # ##### # ##### ### # ##### # ### ##### # ###

#   # #     # # #       # #     #   #   #   # # # #

### # ####### # # ### # # ##### ##### ### # ### # #

#   #   # #   #   #   #   #   #     #     #   #   #

# ##### # # ####### ####### # ##### ######### #####

# #   # # # #     #   #   # #     #   #   #       #

# # ### # # ### # # # ### # ##### ### # # # #######

#   #     # #   #   #     #     #   #   # #   #   #

### # # ### # ################# ### ##### ### # # #

#   # # #   #         #     # # #   #   # #   # # #

# ### ### # ######### ### # # # ##### # # # ### # #

#         #         #     #   #       #   #     #  

###################################################