 31 51
###################################################
********# #   #*******#***#.....#...#.....#...#...#
# #####*# # ###*# ###*#*#*#.#####.#.#.###.###.#.#.#
# #*****#*******#   #***#*#.......#.#...#.....#.#.#
# #*#####*######### #####*#########.#####.#####.#.#
# #***#..***#   #   #   #*********..#.#...#...#.#.#
# ###*#.###*# ### ### ###########*###.#.###.#.#.#.#
# # #*#...#*# #   #         #    *......#.#.#.#.#.#
# # #*###.#*# # ### # # ##### ###*###.###.#.#.#.#.#
#   #***#.#*#   #   # #       #***#...#...#.#...#.#
#######*###*###################*###.###.#.#.#####.#
#   #***#***#...#.........# #  *#.#...#.#...#.....#
### #*###*###.#.#.#######.# # #*#.###.#.#####.#####
#***#***#*#...#.#.....#...#   #*#.....#.....#.....#
#*#*###*#*#####.#####.#.#.#####*###########.###.#.#
#*#*****#*#***#...#...#.#...#***#  *****#...#...#.#
#*#####.#*#*#*###.#####.###.#*#####*###*#.###.###.#
#*#   #.#***#*..#.....#...#.#*****#*#  *..#...#...#
#*### #.#####*#.#####.###.#.#####*#*###*#####.#.###
#***# #.....#*#.#.......#.#.....#***#***#***#.#.#.#
###*# #######*#.#.###.#.#.#####.#####*###*#*###.#.#
#***#   # #***#...#...#...#...#.....#*****#***#...#
#*##### # #*#######.#######.#.#####.#########*#####
#*#   # # #*#.....#...#...#.#.....#...#...#***....#
#*# ### # #*###.#.#.#.###.#.#####.###.#.#.#*#######
#***#     #*#...#...#.....#.....#...#...#.#***#***#
###*# # ###*#.#################.###.#####.###*#*#*#
#***# # #***#.........#.....#.#.#...#...#.#***#*#*#
#*### ###*#.#########.###.#.#.#.#####.#.#.#*###*#*#
#*********#.........#.....#...#.......#...#*****#**
###################################################
