11 15
###############
    #   #   # #
### # # # # # #
#   # #   #   #
# ### ####### #
#   # #   #   #
### # # # # ###
# # #   # # # #
# # # ### # # #
#     #   #    

###############

