11 21

#####################

  #     #   #       #

# ##### # # # ##### #

#   #   # #   #   # #

# # # ### ##### ### #

# # #     #   #     #

# # ### ### # ##### #

# #   # # # #     # #

# ### # # # ### ### #

#   #   #     #      

#####################