11 15
###############
****#***#***# #
###*#*#*#*#*# #
#***#*#***#***#
#*###*#######*#
#***#*#...#***#
###*#*#.#.#*###
# #*#*..#.#*# #
# #*#*###.#*# #
#  ***#...#****

##############
