 11 21
#####################
**#     #***#*******#
#*##### #*#*#*#####*#
#***#   #*#***#   #*#
# #*# ###*##### ###*#
# #*#  ***#   #    *#
# #*###*### # #####*#
# #***#*# # #     #*#
# ###*#*# # ### ###*#
#   #***#     #    **
#####################
